##########
#c.......#
#........#
#........#
#........#
#........#
#.....p..#
#........#
#........#
##########