##########
#c.......#
#.....pp.#
#.....p..#
#.i...pp.d
#.....p.p#
#.....p..#
#.p..p...#
#..ppp...#
##########