######9###
#........#
#........#
#........#
#........#
#........#
#........#
#........#
#........#
######3###