##########
#..,.....F
#........#
#........#
#........#
#.c......#
#.....c..#
#..c.....#
#.....c..#
##########