##########
#........#
B........#
#..ppp...#
#....p...#
#....p...D
#..c.p...#
#..c.p...#
#..c.p...#
##########