#F########
#........#
#........#
#........#
#........#
C........#
#........#
#........#
#........G
###6######