##########
#...c....#
#..c...c.#
#..c..c..#
#.c..c...#
#..c.c.cc#
#c.c.c...#
#..c..cc.#
D...c..c.#
##########