###B######
#p..p#####
#p..p#####
#p..p#####
#p..pppc##
#p..p##c##
#p..p##c##
#p..p#####
#p..p#####
##8#######