##########
#........#
6........#
#........#
#........#
#........#
#........#
#........#
#........#
######5###