##########
#.....ccc#
6........#
#ppp..pp.#
#..p.....#
#.cp.....#
#..p.....#
#..p.....#
#.cp.....#
######5###