##########
#.ccc....#
#..ccc...#
#ppppp...#
#....p...#
#.pp.p...4
#.cp.p...#
#..p.....#
8..pppppp#
##########