###D######
#........#
#........9
#........#
#........#
#........#
#........#
#........#
#........#
#####4####