##########
E.ppp.c.c#
#..c.....#
#pppppp..#
#........#
#..pppppp#
#........#
#pppppp..#
#........#
#D########