##A#######
#........#
#..pcp...#
#..pcp...#
#..pcp...#
#..pcp...#
#..pcp...#
#..pcp...#
#..ppp...7
##########