##########
#........#
#........C
#........#
#........#
#........#
#........#
#........#
#........#
###A######