######5###
#c.......#
#pppp....#
#........#
#........#
2........#
#......p.#
#....pppc#
#####pccc#
##########