##########
#........F
#........#
#........#
#........#
#........#
#........#
#........#
#........#
##########