#2########
#........#
#......c.#
#........#
#........#
#........#
#.c......#
#........#
#.....i..#
##########