##########
#........#
B........#
#........#
#........#
#........D
#........#
#........#
#........#
##########