##########
#........#
#........#
#........#
#........#
#........4
#........#
#........#
8........#
##########