###D######
#..c.....#
#....p.p.9
#.p......#
#....p...#
#........#
#...p..c.#
#........#
#........#
#####4####