##########
#...c.p..#
#...p..p.C
#....p...#
#.p..cp..#
#....pc..#
#.c...p..#
#..pp.c..#
#.....p..#
###A######