###4######
#........#
#.ppp....#
#........#
#....pppp#
#....p...3
#....p...#
#....p...#
#i.......#
#1########