######9###
#........#
#........#
#........#
#........#
#.c......#
#.c......#
#.c......#
#........#
######3###