#F########
#........#
#........#
#..pppp..#
#..p##p..#
C..p##p..#
#..pppp..#
#........#
#........G
###6######