##A#######
#........#
#........#
#........#
#........#
#........#
#........#
#........#
#........7
##########