###B######
#........#
#........#
#........#
#........#
#........#
#........#
#........#
#........#
##8#######