##########
E........#
#........#
#........#
#........#
#........#
#........#
#........#
#........#
#D########