#####6####
#........#
#........#
#..pppp..#
#..p..p..#
7..p..p..#
#..pppp..#
#.......c#
#......cc#
###2######