#####6####
#........#
#........#
#........#
#........#
7........#
#........#
#........#
#........#
###2######