###4######
#........#
#........#
#........#
#........#
#........3
#........#
#........#
#i.......#
#1########